#####.....
#.........
#....###..
#......#..
#...@..#..
..#......#
..#......#
..###....#
.........#
.....#####